8 9
8 7 1 1 1 7 7 8
1 1 1 2 2 2 1 1
1 3 6 4 2 2 1 1
1 1 8 2 4 3 7 1
1 3 1 1 4 2 1 7
1 2 7 2 3 2 1 1
1 4 3 5 4 4 3 1
1 2 2 2 3 2 2 7
8 7 1 1 1 7 7 8



