10 16

1 1 1 1 1 1 1 1 1 1
1 2 2 2 2 2 1 2 2 1
1 2 2 4 2 2 4 4 2 1
1 2 2 1 2 1 2 2 2 1
1 1 1 1 2 1 1 1 3 1
1 2 2 1 2 2 2 1 3 1
1 2 4 2 2 4 2 1 3 1
1 2 2 1 1 3 1 1 3 1
1 1 3 1 1 2 2 1 3 1
1 2 4 2 2 4 2 1 3 1
1 2 2 2 1 2 2 1 3 1
1 1 1 2 1 1 1 1 3 1
1 1 1 2 1 2 2 6 2 1
1 2 2 4 2 2 4 4 2 1
1 2 2 2 2 2 2 2 2 1
1 1 1 1 1 1 1 1 1 1