10 9

1 1 1 1 1 1 1 1 1 1
1 2 2 1 1 1 1 1 1 1
1 2 2 3 3 3 3 3 3 1
1 2 2 1 1 1 1 1 2 1
1 1 2 2 2 4 6 1 2 1
1 1 2 2 4 4 4 4 2 1
1 1 1 2 2 4 2 1 1 1
1 1 1 2 2 2 2 1 1 1
1 1 1 1 1 1 1 1 1 1